D D F F F F F F F F F F F F F
D D S S S C S S S S S S S A F
F S S S S S S S S S S S S S F
F S S S S S S S T T T T S S F
F S S S S S S S T P L T S S F
F S S S S S S S T T T T S S F
F S S T T T S S S S S S S S F
F S S T X T S S S S S S S S D
F S S T L T S S S S S S S S D
F S S T T T S S S S S S S S D
F S S T T T S S S S S S S S D
F S S S S S S S S S S S S S D
F C S S S S S S S S S S S S D
F S S S S S S S S S S S S S F
F S S S S T T T T T S S S S F
F S S S S T B L G T S S S S F
F S S S S T T T T T S S S S F
F S S S S S S S S S S S S S F
F A S S S S S S S S S S K A F
F F F F F F F F F F F F F F F