D D F F F F F F F F F F F F F F D D F F
D D S S 2 C S S S S S S 1 A F S S S S F
F S S S S 2 S F T T T T 1 1 F S S S S F
F S S S S S S F T P L T S S F S S S S F
F S S S S S S F T T T T S S F S S S S F
F F F F F F F F S S S S S S F S S S S F
F C S T T T S F S F S F S F F S S S S F
F S S T X T S F S S S S S S F S S S S F
F S S T L T S F F S F S F S S S S S S F
F S S T X T S S S S S S S S F S S S S F
F S S T T T S S S F S F S F F S S S S F
F S S S S S S F S S S S S S F S S S S F
F F S F F F F F F F F F S S F F F F F F
F A S F S S S S S S S F S S F A A A A F
F S S F S T T T T T S F S S F S S S S F
F S S F S T B L G T S F S S F S S S S F
F S S F S T T T T T S F S S F S S S S F
F S S F S S S S S S S S S S S S S S S F
F A C F S S S S S S S S K A S S S S C F
F F F F F F F F F F F F F F F F F F F F