D D F F F F F F F F F F F F F F F F F F 
D S S S S S S 1 S S S S S S S S S S S F
F S S S S S 1 P 1 S S S S S S S S S 2 F
F S S S S S S 1 S S S S S S S S S 2 M F
F F F F F F F F F F F F S F F F F F F F
F Y 8 S S S S S F K S S S S S S S S L F
F 8 S S S S S S S S S S S S S S T G T F
F S S S S S S S F S S S S S S S T 5 T F
F F S F F F F F F S S S S S S S 5 B 5 F
F S S S F 4 O 4 F 6 S S S S S S T 5 T F
F S S S F S 4 S F H 6 S S S S S S S L F
F S S S F S S S F F F F F F F F F F F F
F S S S F S S S S S S 9 X 9 F R L L C F
F S S S F S S S S S S S 9 S F 7 S S 3 F
F S S S F F F F F F F F S F F S S S S F
F S S S S S S S S S S S S S S S S S S F
F S S S S S S S S S S S S S S S S S S D
F L S S S S S S S S S S S S S S S S S D
F F F F F F F F F F F F F F F F F F F F 